#######################################
# BBBBBBBBBBBBBBBB # BBBBBBBBBBBBBBBB #
# B #### B ##### B # B ##### P #### B #
# O #### B ##### B # B ##### B #### O #
# BBBBBBBBBBBBBBBBBBBBBBBBBBBBBBBBBBB #
# B #### B # B ######### B # B #### B #
# BBBBBBBB # BBBBB # BBBBB # BBBBBBBB #
######## B ##### B # B ##### B ########
       # B # BBBBBBBBBBBBB # B #
       # B # B ###BBB### B # B #
######## B # B ##BBBBB## B # B ########
#BBBBBBBBBBBBB ##EBEEE## BBBBBBBBBBBBB#
######## B # B ######### B # B ########
       # B # BBBBBBBBBBBBB # B #
######## B # B ######### B # B ########
## BBBBBBBBBBBBBBB # BBBBBBBBBBBBBBB ##
## O ### B ##### B # B ##### B ### O ##
## BBB # BBBBBBBBBBBBBBBBBBBBB # BBB ##
##   B # B # B ######### B # B # B   ##
#### B # B # B ######### B # B # B ####
# BBBBBBBB # BBBBB # BBBBB # BBBBBBBB #
# B ############ B # B ############ B #
# BBBBBBBBBBBBBBBBBBBBBBBBBBBBBBBBBBB #
#######################################