##########################################
#   B     B                    B         #
# # ###### # ###################### # ## #
# # #    # #         P       B #    # #  #
# # # ## # ######### ### ######## # # #O #
# # # ## #        O               # # #  #
# # #### # ### ########### ######## # ## #
#O#      #   #  O  E E E E   #      #    #
# ###################################### #
#       B                    B         B #
#  ##############   ###   #############  #
#  #     B      #         #           #  #
#  # ## # #######  ###  ####### # ##  #  #
#B # #  #      O          #     # #   #  #
#  # #  #### ########### ###### # #   #  #
#  # #     #    B               # #B  #  #
#  ######### #######################     #
#                                        #
##########################################